111111111
1E001C001
100011101
102000001
100000001
10X0N10P1
111111111