111111111
1E0010001
100011101
100000001
100000001
1000010P1
11111111E